genome	S288C_yeast
vector	pccFOS2
left_reads	Yeast_BAC_PE_L
right_reads	Yeast_BAC_PE_R
pool_file	barcodePostpoolYeast_BAC_barcodepair
left_readlength	301
right_readlength	301
barcode_length_standard	20
barcode_length_min	4
barcode_length_max	30
flag_length	5
SQ_threshold	20
SQG_threshold	20
BAC_variance	3
right_upstream1	GAGGCTCCCAC
right_upstream2	GGCCGCAAGGG
right_upstream2_rc	CCCTTGCGGCC
right_cutsite	AAGCTT
right_anchor1	73
right_anchor2	33
left_upstream1	GGGGCTCCCAC
left_upstream2	GGCCGCAAGGG
left_upstream2_rc	CCCTTGCGGCC
left_cutsite1	AAGCTT
left_cutsite2	GATCCG
left_cutsite3	AAGCTT
left_anchor1	47
left_anchor2	51
mismatch_hindiii	1
mismtach_nohindiii	7
left_bridge	C
right_bridge	G
inverse_PCR_cutsite	GCGGCCGC
