genome	final.assembly_BACsplit
left_reads	flounder_BAC_PE_part1_L
right_reads	flounder_BAC_PE_part1_R
pool_file	barcodePostpoolflounder_BAC_barcodepair_part1
left_readlength	126
right_readlength	126
barcode_length_standard	20
barcode_length_min	4
barcode_length_max	30
flag_length	5
SQ_threshold	20
SQG_threshold	20
BAC_variance	3
right_upstream1	GTATGCATCCA
right_upstream2	GTCGGACGCTT
right_upstream2_rc	AAGCGTCCGAC
right_cutsite	GCTCGAGCTAGCTAGGG
right_anchor1	38
right_anchor2	20
left_upstream1	TCACGCGTCTC
left_upstream2	GTTGGAATTCG
left_upstream2_rc	CGAATTCCAAC
left_cutsite1	TTAGGG
left_cutsite2	GACTCG
left_cutsite3	TTAGGG
left_anchor1	40
left_anchor2	27

mismatch_hindiii	1
mismtach_nohindiii	7
left_bridge	C
right_bridge	A
inverse_PCR_cutsite	AAGCTT
