prepool_reads	flounder_BAC_barcodepair_bootstrap_only
prepool_readlength	101
prepool_fragmentlength	130
barcode_length_standard	20
barcode_length_min	4
barcode_length_max	30
pool_distance	1
pool_distance_internal_prepool	3
pool_distance_internal_postpool	2
SQ_threshold	20
pool_variance	3
prepool_left_upstream	ACGCGTCTC
prepool_left_downstream	GACTCGAGC
prepool_right_upstream	ACTCGAGCC
prepool_right_downstream	TGGATGCATA
postpool_left_upstream	AGCTCGAGCCC
postpool_left_downstream	GGATGCATT
postpool_right_upstream	CACGCGTCT
postpool_right_downstream	CGACTCGAGA
site_prepool	CTCGAG
prepool_left_anchor	40
prepool_right_anchor	38
postpool_left_anchor	54
postpool_right_anchor	123
middle	CGACTCGAGCCC
postpool_reads	flounder_BAC_barcodepair_part1
postpool_readlength	126
postpool_fragmentlength	237
